правовед: правовед
подеваться: подевались
умение: умение
пространство: пространстве
хороший: лучшим хорошие лучше хороших лучшему лучший лучшую
они: им них их ним
юридический: юридического юридических
население: населения население
стать: ставший стать стали стала станет статей стал
язык: языке языком язык языка
форум: форум
ряд: ряд
столица: столице
центр: центров центр центре
белявский: белявская
официальный: официальных официальное официального официальным
где: где
православный: православной православный
ограниченный: ограниченный ограниченной
покров: покров
телевизионный: телевизионных телевизионный
съёмка: съёмках
русский: русский русской русского
издать: издана
художник: художник
сталкиваться: сталкиваются
участвовать: участвовать участвовал
несколько: несколько нескольких
произведение: произведениях произведение произведений
что-то: что-то
роль: роли ролей роль ролях
свобода: свобод
основать: основанный
фильм: фильмы фильма фильм фильму фильмах фильмов
собор: собор собора
прокат: прокате прокат
сделать: сделал сделайте сделать
технический: технического
европа: европе европы
получать: получать
северный: северной
прежний: прежнего
работа: работе работ работу работы
узнавать: узнаваемых
объединить: объединённом объединены
наука: наука наук
70-й: 70-й
запланировать: запланирован запланированный
антология: антология
продать: проданных
начало: начало начала начале
голливуд: голливуда
актёрский: актёрская
место: место местами месту
запад: западе
серлинга: серлинга серлинг
ямашева: ямашева
здравоохранение: здравоохранения
каждый: каждый
гигиена: гигиены
территория: территории территория
бронный: бронной
принцип: принципам принципах принципов
идеал: идеалам
произносить: произносит
речь: речь речи
критерий: критериям критерии критерием
одновременно: одновременно
быть: был будет было быть была были
журнал: журнал журнале
номинация: номинация номинации
постановка: постановка
разновидность: разновидность
роман: роман роману романа романе
избранный: избранные избранное избранный
пройти: прошли пройдя
это: это этом этого
бергенди: бергенди
редактировать: редактировать
эпизод: эпизодов эпизод эпизода
сср: сср
экспериментальный: экспериментальный
религия: религия
многий: многих
образование: образование
собрание: собрания
событие: события событиями
англоязычный: англоязычный англоязычные
выпускник: выпускник
сказание: сказаний
год: годы годах год году года годов лет
страна: страны
древний: древней
поиск: поиска поиск поиске
действовать: действующий
философия: философия
импрессионист: импрессионистов
пейль: пейли
получить: получившая получил
европейский: европейскую
британский: британский британского британской британскому
песня: песен
мортема: мортем
томас: томаса
преобладать: преобладает
документальный: документальных
мочь: можете могла мог могли может могут
звук: звук
случай: случаях
продюсер: продюсер
история: историю истории история
октябрь: октябрь октября
поломка: поломок
мб: мб
охлократия: охлократии
киев: киев
широкий: широком
выборы: выборы выборах
бердымухаме́д: бердымухаме́дов
родиться: род
джесси: джесси
євген: євген
вода: вода
ретроспективный: ретроспективное
область: области
течение: течение
персонаж: персонажей персонажи
паранормальный: паранормальные
входить: входит входил
экспериментировать: экспериментируйте
момент: момент момента
комсомол: комсомола
расширить: расширенном
1870-й: 1870-х
последующий: последующий
кит: кита
январь: января январе январь
настоящий: настоящее
тысячелетие: тысячелетия
выбрать: выбрала
избрать: избран
выпуск: выпуску выпуск
предназначить: предназначен
должный: должен
восточный: восточной
граничить: граничит
апрель: апреля апрель
гуманизм: гуманизма
шпаргалка: шпаргалка
первый: первая первое первой первым первый первого
перечень: перечень
село: село селе
ора́тор: ора́тор
внутригородской: внутригородского
кимберли-кларк: кимберли-кларк
пять: пять
фарфоровый: фарфоровая
пальмовый: пальмовая
распространение: распространение
радио: радио
объявить: объявлены объявлено объявил
вика: вики
построить: построен построенной построено
пиксель: пикселей пикселя
городской: городского
море: моря
март: марта март
защита: защите
номинант: номинант номинанты
передача: передача
ход: хода
лауреат: лауреат
хусаин: хусаина
который: который которой которых которое которые которого которая которую
пост: пост
представитель: представителей представителем представитель представители
здравый: здравый
бояться: бойтесь
противоречащий: противоречащих
вы: вам вы
сеть: сеть сетей
идол: идол
спрос: спроса
сан-франциско: сан-франциско
зона: зона зону зоны
помочь: поможет помогите
том-танкобон: томах-танкобонах
мнение: мнению
собрать: собрали
росси́йский: росси́йская
зал: зале
орден: ордена орден
множество: множество
предоставление: предоставление
ранний: ранний раньше
запись: записях
город: город города городе
академический: академическая
впервые: впервые
образ: образом
пьер: пьера
давать: давайте
гавриил: гавриила
колокольный: колокольная
юг: юге
наклон: наклону
использование: использование
псевдоготика: псевдоготики псевдоготика
файл: файла файл
уильям: уильям
умфравиль: умфравиль умфравилей
применять: применяемый
средний: средней
член: членом
мария: марии мария
архитектура: архитектуры архитектуру архитектуре
автор: автор
основатель: основатель
барба́дос: барба́доса
англ: англ
загрузить: загрузить
выйти: вышел вышедших
радоваться: радуйся
уилла: уилл
сценарист: сценаристов сценарист
параметр: параметры
евгений: евгений
бухта: бухте
век: века
победительница: победительницей
всегда: всегда
архитектор: архитекторе архитектор архитектором
свободный: свободные свободный свободным свободных свободному свободная свободное
иной: иных
актриса: актриса
три: трёх
ресторан: ресторанов ресторан
американский: американского американская американский американскую
находиться: находящуюся находящийся находиться
парламентский: парламентской
турецкий: турецким
конкурс: конкурс конкурсе конкурса
суннит: сунниты
1950-й: 1950-х
часть: часть части частей
указание: указания
радиосеть: радиосетей
претендент: претендентов претендента
концертный: концертном
мир: мире миру мира
ваш: вашу
бердымухамедов: бердымухамедову
олександрович: олександрович
соблюдение: соблюдение
картина: картина картин картины картину
девятаев: девятаева
глобус: глобус
июнь: июня июнь
научный: научная
стиль: стиле
выпускаться: выпускается
также: также
вручать: вручаемых
синъить: синъити
пуэрто-рико: пуэрто-рико
кб: кб
веллингтон: веллингтон
фридрих: фридрих
кавычка: кавычки
многоязычный: многоязычная
весь: всему всего всех
творческий: творческих творческий
определение: определению
он: он его
фантастика: фантастика
французский: французского французский
написать: написал написанная написанный
дама-компаньон: дама-компаньон
работник: работник
азия: азии
по́льша: по́льша
75-я: 75-я
дополнительный: дополнительная дополнительные
начинать: начиная
пианино: пианино
культовый: культовым
материал: материал материалы материалу
дворец: дворцом дворца
сыгранный: сыгранных
русь: руси
политический: политический
королева: королевы королева
де: де
непреднамеренный: непреднамеренному
подряд: подряд
профессиональный: профессиональный профессиональной
предводитель: предводитель
монарх: монарха
зимний: зимнего
кой: кой
называть: называемых называют
торгово-промышленный: торгово-промышленное
носитель: носителя
драма-антология: драмой-антологией
обратить: обратить обращённый
законодательный: законодательных
готика: готика
конституционный: конституционных
католический: католическая
себя: собой себя
мусульманин: мусульмане
некогда: некогда
новый: новых новая новые новому
производственный: производственное
прогрессивный: прогрессивный
содружество: содружества
установленный: установленным
зеркало: зеркало
содержание: содержание
приём: приём
высокий: высоким
значимость: значимости
участие: участии
затем: затем
гоге́н: гоге́н
спокойно: спокойно
начать: начал
убеждать: убеждать
сентябрь: сентябрь сентября
тревожный: тревожными
контора: конторе
шкура: шкура
вымирание: вымиранию
самый: самым самых
четыре: четырёх
осевой: осевыми
два: две двух
ридсдейл: ридсдейла
церемония: церемония церемонии
сша: сша
слобода: слобода слободы
одноимённый: одноимённому одноимённой одноимённом одноимённый
сура: суру
доберетёсить: доберетёсь
телеканал: телеканала
применяться: применялся
программа: программы программу
восток: востоке
июль: июль июля
происходить: происходит
шаг: шаг шагов
название: название названия
вручаться: вручается вручалась
универсальный: универсальная
всемирный: всемирную
другой: других другой
гурбангул: гурбангулы
ру́сскай: ру́сская
скорректировать: скорректировать
являться: являлась являются являющийся является
список: список списке списки
её: её
пёс: пса
альберт-холл: альберт-холл
нирвана: нирвана
карьера: карьеру
иран: ираном
точный: точной
итал: итал
далем: далем
подстраница: подстраницы подстраницу
смотреть: см смотрите
дева: деве
молодой: молодым
желательно: желательно
обсуждаться: обсуждается
заработать: заработав
большинство: большинства
театр: театр театре
исключение: исключений исключения
мультипликационный: мультипликационных
эпана́фор: эпана́фора
производство: производству
государственный: государственного государственный
ленинградский: ленинградский
поле: поля
эпанафора: эпанафора
правовой: правовое
башня: башня
эмми: эмми
персоналия: персоналий персоналии
техника: техника
вахитовский: вахитовского
кладбище: кладбищем
содержимое: содержимое
актёр: актёр актёром актёры актёру актёров
править: править
человек: человека человек
гафурить: гафури
форма: форма форм
популярность: популярностью
энди: энди
рыцарь: рыцарь
такой: таким
дом: домов
страница: страницы странице страниц
штаб-квартира: штаб-квартира
нестеровца: нестеровцы
mime-тип: mime-тип
поэзия: поэзии
смит-макфи: смит-макфи
меховщик: меховщиков
современник: современник
стык: стык
фраза: фраза фразы
развитие: развитие
буля: буля
ратифицировать: ратифицировала
новозеландский: новозеландский новозеландского
торговля: торговле
марсианин: марсианин
храм: храм храмом
правка: правку
поздний: позже
следующий: следующего
буква: букв
представительница: представительница
дама: дама
туркмения: туркмении
кто: кто кому
деятель: деятель
свой: свою своём
один: одним один одна одной
английский: английский английского
государство: государство государства государств
конструкция: конструкции
география: география
си-би-эс: си-би-эс
татарстан: татарстана
корпорейшн: корпорейшн
найти: найти найдите
находить: находили
иностранный: иностранные иностранном иностранному
памятка: памятка
не: не
мораль: моралью
продукция: продукции
составлять: составляет составлял
ленин: ленина
рок-группа: рок-группы
сказать: сказанное
постимпрессионист: постимпрессиониста
специалист: специалист
жан: жан
гурбангулы́евич: гурбангулы́евич
го́тик: го́тика
сериал: сериале сериалов сериал
улучшить: улучшить
отменить: отменена
значение: значении
передать: передать
конец: концу конец конце
бисука: бисуку
директор: директор директором
герой: герой
федера́ция: федера́ция
уи́ллард: уи́ллард
фр: фр
творчество: творчества
нортумберленд: нортумберленд
изображение: изображения
исключительный: исключительный
туркменский: туркменская туркменский
узбекистан: узбекистаном
состоять: состоял
барбадос: барбадоса
отечественный: отечественной
сказка: сказок
сезон: сезонов сезона
ново-татарский: ново-татарская
ошибка: ошибки
президентский: президентские
описание: описаний
рок: рок
ребел: ребел
широковещательный: широковещательных
предприятие: предприятие
этот: эту этот эта этой
определённый: определённому
создать: создать созданный
тверской: тверской
купить: купил
состояться: состоялась состоялся
графство: графства
недавний: недавних
война: войны
удостоить: удостоена
серда́р: серда́р
устарый: устар
музыка: музыка музыки
гоген: гогена
корпорация: корпорация
кэмпион: кэмпион
богема: богемы
декабрь: декабря декабрь
компания: компании компания
необычный: необычными
торжокский: торжокского
случайно: случайно
афганистан: афганистаном
русый: рус
филадельфия: филадельфия
лата: лат
марка: марке
дракон: дракон
благовещение: благовещения
знаменитый: знаменитых
исходный: исходный
лента: лентах
студия: студии
звериный: звериная
телерадиосеть: телерадиосеть
статья: статью статьи
бенедикт: бенедикт
наиболее: наиболее
волосяной: волосяной
кодить: коди
любой: любую любое любой
ю́рия: ю́рий
основный: основных основную
авторитетный: авторитетного
источник: источником источниками
сооружение: сооружению
культура: культуры
далее: далее
шерсть: шерстью
кинематография: кинематографии
игра: игра
шестикратный: шестикратный
анонс: анонс
величество: величества
чаво: чаво
предел: пределах
выработать: выработанных
соно: соно
бывш: бывш
май: май мая
право: права прав
анадиплосис: анадиплосис
ава: аве
красота: красоты
царскосельский: царскосельскому
санкт-петербург: санкт-петербурге
мазит: мазита
отображать: отображаемый
традиционный: традиционная
правило: правило правил правила
конвенция: конвенцию конвенции
текст: текст
действие: действий действие
премьера: премьера
некомфортно: некомфортно
устный: устным
известный: известен
девятый: девятое
лондон: лондоне
наблюдатель: наблюдателя наблюдателей
привязать: привязана
поддержка: поддержка
яп: яп
венг: венг
чесменский: чесменская чесменской чесменским
памятник: памятник
сумеречный: сумеречная сумеречной сумеречную
приверженность: приверженность
больший: больших наибольшую
развитой: развитое
туркм: туркм
вейер: вейером
мужской: мужскую
оскар: оскар
отредактировать: отредактируйте
постепенно: постепенно
результат: результате
режиссёр: режиссёром режиссёра режиссёрам режиссер
возвести: возведён
драма: драмы
связать: связан
вашингтон: вашингтон
петер: петера
скульптор: скульптор
архангел: архангела
красноречие: красноречия красноречие
район: района
великий: великой
победа: победы
ленсовет: ленсовета
жизнь: жизни
генерация: генерации
категория: категория категориях категории
выход: выхода
академия: академией академии
песочница: песочнице песочница
конкурсный: конкурсную
37-быть: 37-е
википедия: википедию википедия википедии
редактор: редактор
главный: главных главная главный главной
добротный: добротные
рубрика: рубрики
золотой: золотой золотая
немного: немного
умереть: умер
соответствующий: соответствующих
обладать: обладающий
росси́ть: росси́я
считаться: считается
принести: принесла
персона: персон
известность: известность
публика: публикой
обладатель: обладатель
запустить: запустил
млекопитающее: млекопитающих
джейн: джейн
уи́лла: уи́лл
система: систему
любитель: любитель
премия: премию премия премий премии
февраль: февраль февраля
страдать: страдающий
соответственно: соответственно
серлинг: серлингом
барон: барон
гог: гогом
портал: порталы портал
великобритания: великобританию великобритании
север: севере
избежание: избежание
королевство: королевствах королевстве
обеспечивать: обеспечивает
э́двард: э́двард
подтвердить: подтвердила
часто: часто
санта-мария-ассунт: санта-мария-ассунта
владеть: владеющий
жилой: жилым
пандемия: пандемии
декоративно-прикладной: декоративно-прикладном
процесс: процессе
награда: награду награда наград награды
старицкий: старицкого
график: график
объединение: объединение
же: же
сложность: сложности
оригинальный: оригинальный
число: числу
контент: контент контентом
культурный: культурном
крупный: крупнейшим
ассамблея: ассамблеи
гитарист: гитарист
второй: второй
статус: статус
шесть: шести
элизабет: элизабет
телевидение: телевидении телевидения
сказительство: сказительство
демократия: демократии
пользоваться: пользовался
звание: звание
просто: просто
сезанн: сезанном
имя: имени
выпустить: выпущены
планета: планета
фе́льтен: фе́льтен
мировой: мировой мирового
капитульный: капитульным
сиэтл: сиэтл
малый: малый малой
справка: справка
манга: манга
здание: здании зданием здание
граница: границах
импрессионизм: импрессионизмом
появиться: появилась
общий: общая общей
украинский: украинский украинской
канал: канале
улица: улицы улицей улице
трудовой: трудового
говорящий: говорящего говорящий
отнесение: отнесения
москва: москве
комитет: комитета
использовать: использующих использовать
она: она ею
ноябрь: ноября ноябрь
вспоминать: вспоминает
россия: россия россии
научно-фантастический: научно-фантастический
живописец: живописец
промышленный: промышленной
орфографический: орфографические
слушать: слушать
бердымухамед: бердымухамедов
пиза: пиза
до́нальда: до́нальд
епархия: епархии
мисс: мисс
сердар: сердару
престижный: престижных
создатель: создатель
кирстен: кирстен
фестиваль: фестивалях
информация: информации информация
почти: почти
эфир: эфире
включать: включала
неожиданный: неожиданным
президент: президент
последний: последний
писатель: писатель писателей писателя
вхождение: вхождения
красный: красном
джон: джона
молитва: молитва молитву
окружение: окружение
ро́дман: ро́дман
зародиться: зародился
чувствовать: чувствовать
социальный: социального
регион: регионе регионы
сан-хуан: сан-хуан
ансамбль: ансамбль ансамбля
ужас: ужасам ужасов
заниматься: заниматься
человечество: человечества
первоначальный: первоначальном
переименовать: переименована
сын: сыну
строгий: строгих
церковь: церкви церковь
рф: рф
заслуга: заслуги заслуг
чел: чел
тау: тау
реализовать: реализованная
будущее: будущем
матве́евич: матве́евич
южный: южного
переживание: переживаниями
финал: финалом
ввп: ввп
земля: земли
поль: поль
использоваться: используется
кукла: кукла
википе́дия: википе́дия
немой: нем
впасть: впавший
заявить: заявленной
кинорежиссёр: кинорежиссёр
внеочередной: внеочередные
туркмениста́н: туркмениста́н
кэмпбелла: кэмпбелла
обязанность: обязанностей
предте́чить: предте́чи
победитель: победителем
иногда: иногда
род: родом рода
выступить: выступил
некоторый: некоторых
административный: административный
художество: художеств
федерация: федерация
исторический: исторический исторических
бедный: беден
джаз-фьюжн: джаз-фьюжн
функциональный: функциональное
шаблон: шаблона шаблон
цыганский: цыганской
иметь: имеет
артемида: артемида
кандидат: кандидат
академик: академика
эгейский: эгейского
добавлять: добавляйте
есть: есть
сценический: сценических
министр: министров
абердин: абердин
фельдтен: фельдтен
опыт: опытом
рассказчик: рассказчик
повторяться: повторяется
хип-хоп: хип-хоп
версия: версии
ярый: яр
российский: российская российский
отличие: отличие
допустить: допущено
астронавт: астронавтом
явление: явлениями
писатель-фантаст: писателю-фантасту
георг: георг
интернет: интернет
пиза́нский: пиза́нская
перенести: перенесён
показать: показан
представлять: представляет
сад: садов
пенсильвания: пенсильвания
численность: численности
респу́блик: респу́блика
преподаватель: преподаватель
смысл: смысле смысл
озвучивание: озвучиванию
произноситься: произносится
отдельный: отдельную
подразумевать: подразумевает
дорогой: дорогих
личный: личном личной
положение: положениям
выступать: выступающий
достижение: достижения
автоматический: автоматической
занимать: занимает
представить: представлен
69-быть: 69-е
третий: третий
близкий: ближайшем
материальный: материальная
данст: данст
читабельный: читабельным
елизавета: елизаветы
кафкианский: кафкианские
персонал: персонала
формат: формат
картинка: картинкой
ведущий: ведущим ведущей
рассматриваться: рассматриваться
даля: даля
участник: участник участники
редактирование: редактировании редактирования
ветвь: ветвь
своеобразный: своеобразный
чей: чьи
грамматический: грамматические
сначала: сначала
фэнтези: фэнтези
совет: совета
лидер: лидер лидеров
приз: призов
солнце: солнца
монастирський: монастирський
предыдущий: предыдущего предыдущие
млн: млн
добавить: добавить
райланда: райланд
проиллюстрировать: проиллюстрированная
площадка: площадках
курт: курт
прото-панк: прото-панк
преображение: преображения
искусство: искусств искусство искусстве искусством искусства
власть: власть
поэтический: поэтическая
вступить: вступит
сэвидж: сэвиджа
грэмми: грэмми
сам: самого
ежегодно: ежегодно
соединить: соединённых
германия: германии
уважаемый: уважаемых
штат: штат штатов
харьковский: харьковского
влюбиться: влюбилась
польша: польши
камеди-рок: камеди-рок
национальность: национальностей
высокооплачиваемый: высокооплачиваемых
психоделический: психоделический
живопись: живописью
склонять: склоняют
венгрия: венгрия
зарубежный: зарубежных
кэ́рролл: кэ́рролл
монастырский: монастырский
помощник: помощником
тигр: тигр
флот: флота
благочиние: благочиния
способ: способ
ирвинга: ирвинг
изделие: изделиями
более: более
стилистический: стилистический
беспокоиться: беспокойтесь
период: период
святой: святого
обилие: обилия
акт: актов
вспять: вспять
режиссёрский: режиссёрскую
волга: волгой
ввести: введена
школа: школы
осуществление: осуществления
первоначально: первоначально
обеспечение: обеспечения
приходский: приходской
каннский: каннского
включить: включена
твёрдый: твёрдых
пизанский: пизанский
итальянский: итальянском
белоруссия: белоруссия
стивенс: стивенс
кинематограф: кинематографа
расположить: расположена
телесериал-антология: телесериал-антология телесериала-антологии
свято́го: свято́го
подвязка: подвязки
ответственность: ответственностью
объём: объёму
татарский: татарская татарским татарское
располагаться: располагающееся
цель: цель
керамистый: керамист
олег: олегом олега
днр: днр
приветствие: приветствием приветствие
качество: качестве
туркме́ние: туркме́ния
центральный: центральной
общество: общество
напутать: напутали
вместе: вместе
путь: путями
тот: тот
феодальный: феодальный
це́рковь: це́рковь
адъюнкт-ректор: адъюнкт-ректоры
пожалуйста: пожалуйста
мех: мех
назначаться: назначались
обезьяна: обезьян
наряду: наряду
меховой: меховыми меховое
иоа́нный: иоа́нна
дорога: дорогу
польск: польск
понять: поймёте
впоследствии: впоследствии
световой: световых
флоретта: флоретт
сценарий: сценариев сценарий
былина: былинах былин
уилсон: уилсон
амнезия: амнезией
кино: кино
даром: даром
радиоспектакль: радиоспектаклей
бывший: бывшему
август: август
роберт: роберт
итог: итогам
растрелли: растрелли
строение: строений
свадьба: свадьба
экран: экран
взять: возьмите
венгерский: венгерского
текущий: текущий
предложение: предложения
кобе́йн: кобе́йн
тракт: тракту
снятой: снятая
вставка: вставки
артист: артиста
неого́тик: неого́тика
смит: смит
шериф: шериф
императорский: императорского
возглавить: возглавил
племонс: племонс
кинофестиваль: кинофестиваля
ван: ван
всё: всё все
состояние: состоянию
выставка: выставках
целый: целый
только: только
вокалист: вокалист
сериал-антология: сериал-антологию
фукуда: фукудой
институт: института
ознаменование: ознаменование
подробный: подробнее
казань: казани
патрулирование: патрулирования
исполнитель: исполнитель
постимпрессионизм: постимпрессионизма
полнометражный: полнометражный
умерший: умерших
относиться: относится
размер: размер
широко: широко
отель: отеля
издательство: издательства
проводиться: проводился
говорить: говорить
генера́л-губерна́тор: генера́л-губерна́тор
ленинский: ленинского
александрович: александрович
знать: знаете
копия: копией
рецензирование: рецензированию
железнодорожный: железнодорожного
задача: задач
вручение: вручения
советский: советский
преподавать: преподавал
крадущийся: крадущийся
рок-музыкант: рок-музыкант
дать: дать
спорт: спорт
мастер: мастер
восемь: восьми
можно: можно
девять: девять
собственный: собственную
энциклопедия: энциклопедия
арсенал: арсенале
художественный: художественных
привести: привести
должность: должность
небоскрёб: небоскрёб
казахстан: казахстаном
ангельский: ангельским
готовность: готовность
сказ: сказа
ложный: ложная
международный: международный
просуществовать: просуществовал
управление: управлением
грейс: грейс
техас: техас
народный: народной
создание: создания
39-й: 39-й
заглавный: заглавную
ораторский: ораторским
господний: господня
исполнение: исполнение
жанр: жанрам
радиостанция: радиостанций
псевдоготический: псевдоготическом
общедоступный: общедоступная
работать: работает
георгий: георгия
доллар: долларов
зеландия: зеландия
кэ́мпион: кэ́мпион
аниме-сериал: аниме-сериала
участница: участниц
провинция: провинции
а́в: а́ве
доступный: доступен
выполнить: выполнить
проект: проект
ашхабад: ашхабад
комма: комм
шестой: шестое
эже́н: эже́н
отправить: отправлен
эрмитаж: эрмитажа
исправить: исправить
кинопремия: кинопремию
стилизация: стилизациях
старый: старым
каролина: каролина
соне́т: соне́т
кинолента: киноленты
пе́заро: пе́заро
камбербэтч: камбербэтч
основное: основном
ссср: ссср
затемнение: затемнение
юго-западный: юго-западной
выполнение: выполнения
предшествовать: предшествующий
мелита: мелита
время: время
драматург: драматург
мастерство: мастерство
затаиться: затаившийся
